REB = "setup/countries/rebels.txt"
PIR = "setup/countries/pirates.txt"
BAR = "setup/countries/barbarians.txt"
MER = "setup/countries/mercenaries.txt"

# Greece/Macedonia
#CRT = "setup/countries/crete.txt"

#New:
ATH = "setup/countries/greece/athens.txt"
SPA = "setup/countries/greece/sparta.txt"
EPI = "setup/countries/greece/epirus.txt"
KRK = "setup/countries/greece/korkyra.txt"
AET = "setup/countries/greece/aetolia.txt"
AKR = "setup/countries/greece/akarnania.txt"
MSE = "setup/countries/greece/messenia.txt"
PTA = "setup/countries/greece/patrai.txt"
DYM = "setup/countries/greece/dyme.txt"
MGL = "setup/countries/greece/megalopolis.txt"
TEG = "setup/countries/greece/tegea.txt"
AIG = "setup/countries/greece/aigon.txt"
PLE = "setup/countries/greece/pellene.txt"
AZA = "setup/countries/greece/azania.txt"
ARG = "setup/countries/greece/argos.txt"
MTE = "setup/countries/greece/mantinea.txt"
ELI = "setup/countries/greece/elis.txt"
COT = "setup/countries/greece/corinth.txt"
TRN = "setup/countries/greece/troizen.txt"
EPD = "setup/countries/greece/epidauros.txt"
PRI = "setup/countries/greece/prasiai.txt"
HRA = "setup/countries/greece/heraia.txt"
LPR = "setup/countries/greece/lepreon.txt"
MAC = "setup/countries/greece/macedonia.txt"
STP = "setup/countries/greece/stymphalia.txt"
MGA = "setup/countries/greece/megara.txt"
THE = "setup/countries/greece/thebes.txt"
EUB = "setup/countries/greece/euboea.txt"
KRY = "setup/countries/greece/karystos.txt"
KEP = "setup/countries/greece/kephallenia.txt"
BOE = "setup/countries/greece/boeotia.txt"
DEL = "setup/countries/greece/delos.txt"
ADR = "setup/countries/greece/andros.txt"
KOS = "setup/countries/greece/kos.txt"
MLO = "setup/countries/greece/miletos.txt"
BYZ = "setup/countries/greece/byzantion.txt"
ION = "setup/countries/anatolia/ionian_league.txt"
CIA = "setup/countries/anatolia/caria.txt"
KNI = "setup/countries/anatolia/knidos.txt"
IOA = "setup/countries/anatolia/aeolia.txt"
CDD = "setup/countries/anatolia/calchedon.txt"
KIO = "setup/countries/anatolia/kios.txt"
SNP = "setup/countries/anatolia/sinope.txt"
AST = "setup/countries/anatolia/astakos.txt"
KZK = "setup/countries/anatolia/kyzikos.txt"
AMS = "setup/countries/anatolia/amisos.txt"
HKS = "setup/countries/anatolia/halikarnassos.txt"
KRS = "setup/countries/anatolia/kerasous.txt"
KYA = "setup/countries/anatolia/kotyora.txt"
PAA = "setup/countries/greece/paeonia.txt"
TAN = "setup/countries/greece/tanagra.txt"
HRM = "setup/countries/greece/hermione.txt"
ORE = "setup/countries/greece/oreos.txt"


# Crimea and Abkhazia

BPK = "setup/countries/greece/bosporus.txt"
SRM = "setup/countries/greece/sarmatians.txt"
OLB = "setup/countries/greece/olbia.txt"
TYS = "setup/countries/greece/tyras.txt"
TYG = "setup/countries/greece/tyrgetae.txt"
MAE = "setup/countries/greece/maeotia.txt"
CHS = "setup/countries/greece/chersonesus.txt"
ORG = "setup/countries/greece/orgame.txt"
ISO = "setup/countries/greece/istros.txt"
TMS = "setup/countries/greece/tomis.txt"
KTS = "setup/countries/greece/kallatis.txt"
KOI = "setup/countries/greece/krounoi.txt"
ODS = "setup/countries/greece/odessos.txt"
MES = "setup/countries/greece/mesembria.txt"
APL = "setup/countries/greece/apollonia.txt"
SND = "setup/countries/caucasiamesopotamia/sindica.txt"
SCE = "setup/countries/caucasiamesopotamia/siracia.txt"
LGA = "setup/countries/caucasiamesopotamia/legia.txt"
SCA = "setup/countries/caucasiamesopotamia/scythia.txt"
#

KNO = "setup/countries/greece/knossos.txt"
PYR = "setup/countries/greece/polyrrhenia.txt"
LYT = "setup/countries/greece/lyctus.txt"
KYD = "setup/countries/greece/kydonia.txt"
GRT = "setup/countries/greece/gortyna.txt"
IEP = "setup/countries/greece/ierapetra.txt"
PRE = "setup/countries/greece/praesos.txt"
ELT = "setup/countries/greece/eleutherna.txt"

## Thracia/Illyria
TRE = "setup/countries/greece/thrace.txt"
ODR = "setup/countries/greece/odrysia.txt"

## Asia Minor
COR = "setup/countries/syria/corduene.txt"

#New
PRY = "setup/countries/anatolia/phrygia.txt"
RHO = "setup/countries/anatolia/rhodes.txt"
BIT = "setup/countries/anatolia/bithynia.txt"
HCP = "setup/countries/anatolia/heraclea_pontica.txt"
CAP = "setup/countries/anatolia/cappadocia.txt"
PON = "setup/countries/anatolia/pontus.txt"
PAP = "setup/countries/anatolia/paphlagonia.txt"

#New
SEL = "setup/countries/caucasiamesopotamia/seleucid empire.txt"
ADI = "setup/countries/caucasiamesopotamia/adiabene.txt"
ARM = "setup/countries/caucasiamesopotamia/armenia.txt"
MAP = "setup/countries/caucasiamesopotamia/media atropatene.txt"
IBR = "setup/countries/caucasiamesopotamia/iberia.txt"
COL = "setup/countries/caucasiamesopotamia/colchis.txt"
ALB = "setup/countries/caucasiamesopotamia/albania.txt"
TRZ = "setup/countries/caucasiamesopotamia/trapezous.txt"
BAC = "setup/countries/bactria/bactria.txt"
PAR = "setup/countries/caucasiamesopotamia/parthia.txt"

# Arabia/Persia
OSR = "setup/countries/syria/osroene.txt"
SOP = "setup/countries/syria/sophene.txt"

#Syria
COM = "setup/countries/syria/commagene.txt"
JUD = "setup/countries/syria/judea.txt"
SMA = "setup/countries/syria/samaria.txt"
BYB = "setup/countries/syria/byblos.txt"
ARA = "setup/countries/syria/arados.txt"
SID = "setup/countries/syria/sidon.txt"
BMB = "setup/countries/syria/bambyce.txt"

####SULLA####

# Italic

ROM = "setup/countries/italia/rome.txt"
SAM = "setup/countries/italia/samnium.txt"
ETR = "setup/countries/italia/etruscia.txt"
UMB = "setup/countries/italia/umbria.txt"
PIE = "setup/countries/italia/picentes.txt"
SAB = "setup/countries/italia/sabinia.txt"
APU = "setup/countries/italia/apulia.txt"
NEP = "setup/countries/italia/neapolis.txt"
FRE = "setup/countries/italia/frentani.txt"
PEL = "setup/countries/italia/peligni.txt"
MSP = "setup/countries/italia/messapii.txt"
SNI = "setup/countries/italia/senonii.txt"
LCA = "setup/countries/italia/lucania.txt"
BRT = "setup/countries/italia/bruttia.txt"
ANO = "setup/countries/italia/ancona.txt"
MET = "setup/countries/italia/metapontum.txt"
TAR = "setup/countries/italia/tarentum.txt"
THU = "setup/countries/italia/thurii.txt"
HCL = "setup/countries/italia/heracleia.txt"
CRO = "setup/countries/italia/croton.txt"
LOC = "setup/countries/italia/locri.txt"
RHG = "setup/countries/italia/rhegium.txt"
HPO = "setup/countries/italia/hipponium.txt"
SCU = "setup/countries/italia/siculia.txt"
CUT = "setup/countries/italia/ceutrones.txt"
SLS = "setup/countries/italia/salassi.txt"
LPO = "setup/countries/italia/lepontii.txt"
LGN = "setup/countries/italia/lingones.txt"
TAU = "setup/countries/italia/taurini.txt"
INM = "setup/countries/italia/intimili.txt"
IGN = "setup/countries/italia/ingauni.txt"
EPA = "setup/countries/italia/epanterii.txt"
INS = "setup/countries/italia/insubri.txt"
CNM = "setup/countries/italia/cenomanni.txt"
KRN = "setup/countries/italia/carni.txt"
VNT = "setup/countries/italia/veneti.txt"
HIS = "setup/countries/italia/histri.txt"
GUN = "setup/countries/italia/genuates.txt"
BOI = "setup/countries/italia/boi.txt"
RAE = "setup/countries/italia/raeti.txt"
BRE = "setup/countries/italia/breuni.txt"
FNT = "setup/countries/italia/friniati.txt"
NUC = "setup/countries/italia/nocera.txt"
MRS = "setup/countries/italia/marsia.txt"
SIO = "setup/countries/italia/sipontum.txt"
SYR = "setup/countries/italia/syracusae.txt"
ACR = "setup/countries/italia/acragas.txt"

#Britannic

CAT = "setup/countries/britannia/cantiaci.txt"
DUR = "setup/countries/britannia/durotriges.txt"
PAS = "setup/countries/britannia/parisi.txt"
DUM = "setup/countries/britannia/dumnonii.txt"
ICE = "setup/countries/britannia/iceni.txt"
SIR = "setup/countries/britannia/silures.txt"
DEM = "setup/countries/britannia/demetae.txt"
COI = "setup/countries/britannia/coritani.txt"
DOB = "setup/countries/britannia/dobunni.txt"
COV = "setup/countries/britannia/cornovii.txt"
ORD = "setup/countries/britannia/ordovices.txt"
DEC = "setup/countries/britannia/deceangli.txt"
BRI = "setup/countries/britannia/brigantes.txt"
CAV = "setup/countries/britannia/carvetii.txt"
#ATR = "setup/countries/britannia/atrebates.txt"
#REG = "setup/countries/britannia/regnenses.txt"
#CAI = "setup/countries/britannia/catuvellauni.txt"
TRI = "setup/countries/britannia/trinovantes.txt"
CAL = "setup/countries/britannia/caledonia.txt"
VTD = "setup/countries/britannia/votadinia.txt"
DNN = "setup/countries/britannia/damnonia.txt"
TXL = "setup/countries/britannia/taexalia.txt"
ULT = "setup/countries/britannia/ulutia.txt"

#Iberian

BLD = "setup/countries/iberia/balearides.txt"
ASU = "setup/countries/iberia/astures.txt"
AUI = "setup/countries/iberia/ausetani.txt"
AUG = "setup/countries/iberia/autrigones.txt"
BAI = "setup/countries/iberia/bastetani.txt"
BAL = "setup/countries/iberia/bastuli.txt"
CLL = "setup/countries/iberia/callaeci.txt"
CBI = "setup/countries/iberia/cantabri.txt"
CRI = "setup/countries/iberia/caristii.txt"
CRP = "setup/countries/iberia/carpetani.txt"
CLB = "setup/countries/iberia/celtiberi.txt"
CLC = "setup/countries/iberia/celtici.txt"
CNT = "setup/countries/iberia/contestani.txt"
CNU = "setup/countries/iberia/couneii.txt"
EDT = "setup/countries/iberia/edetani.txt"
ICV = "setup/countries/iberia/ilercavones.txt"
ILG = "setup/countries/iberia/ilergetes.txt"
IDK = "setup/countries/iberia/indiketes.txt"
LCT = "setup/countries/iberia/lacetani.txt"
ORT = "setup/countries/iberia/oretani.txt"
TUR = "setup/countries/iberia/turdetani.txt"
VCI = "setup/countries/iberia/vaccaei.txt"
VSC = "setup/countries/iberia/vascones.txt"
VET = "setup/countries/iberia/vettones.txt"
EPO = "setup/countries/iberia/emporion.txt"
#MLK = "setup/countries/iberia/malaka.txt"
TAT = "setup/countries/iberia/tartessos.txt"
MST = "setup/countries/iberia/menesthei.txt"
GAD = "setup/countries/iberia/gadir.txt"
MAT = "setup/countries/iberia/mastia.txt"
#CTI = "setup/countries/iberia/carteia.txt"
SGS = "setup/countries/iberia/saguntines.txt"
VAD = "setup/countries/iberia/varduli.txt"
ORM = "setup/countries/iberia/orgenomesci.txt"
AVG = "setup/countries/iberia/avarigini.txt"
COC = "setup/countries/iberia/concani.txt"
CNI = "setup/countries/iberia/conisci.txt"
BLN = "setup/countries/iberia/blendii.txt"
MRC = "setup/countries/iberia/morecani.txt"
TMC = "setup/countries/iberia/tamarici.txt"
VDI = "setup/countries/iberia/vadini.txt"
AMC = "setup/countries/iberia/amaci.txt"
BDU = "setup/countries/iberia/bedunienses.txt"
GGR = "setup/countries/iberia/gigurri.txt"
LCN = "setup/countries/iberia/lancienses.txt"
LGO = "setup/countries/iberia/lugones.txt"
PSC = "setup/countries/iberia/paesici.txt"
SLI = "setup/countries/iberia/selini.txt"
SPT = "setup/countries/iberia/superatii.txt"
TBU = "setup/countries/iberia/tiburi.txt"
ZLA = "setup/countries/iberia/zoelae.txt"
AEB = "setup/countries/iberia/aebocosi.txt"
ABO = "setup/countries/iberia/albiones.txt"
ARR = "setup/countries/iberia/arroni.txt"
BED = "setup/countries/iberia/baedi.txt"
BAN = "setup/countries/iberia/banienses.txt"
BRC = "setup/countries/iberia/bracari.txt"
CLD = "setup/countries/iberia/caladuni.txt"
COP = "setup/countries/iberia/copori.txt"
GRV = "setup/countries/iberia/gravi.txt"
INT = "setup/countries/iberia/interamici.txt"
LUN = "setup/countries/iberia/leuni.txt"
NRI = "setup/countries/iberia/neri.txt"
SUR = "setup/countries/iberia/seurri.txt"
SLN = "setup/countries/iberia/sileni.txt"
TMG = "setup/countries/iberia/tamagani.txt"
VRR = "setup/countries/iberia/varrini.txt"
CSS = "setup/countries/iberia/cessetani.txt"
TDL = "setup/countries/iberia/turduli.txt"
PAE = "setup/countries/iberia/paesuri.txt"
LSI = "setup/countries/iberia/lusitani.txt"
TPL = "setup/countries/iberia/tapoli.txt"
SFI = "setup/countries/iberia/sefia.txt"
CMS = "setup/countries/iberia/cempsia.txt"
TDT = "setup/countries/iberia/oppidania.txt"
EBL = "setup/countries/iberia/elbocori.txt"
IGD = "setup/countries/iberia/igaedetania.txt"
LCC = "setup/countries/iberia/lanciencia.txt"
AVA = "setup/countries/iberia/aravia.txt"
TLS = "setup/countries/iberia/taluria.txt"
BDL = "setup/countries/iberia/bardulia.txt"
TDI = "setup/countries/iberia/turmodigia.txt"
AVC = "setup/countries/iberia/arevacia.txt"
BLT = "setup/countries/iberia/bletonisia.txt"
CLU = "setup/countries/iberia/caluria.txt"
CRE = "setup/countries/iberia/coerensia.txt"
CLO = "setup/countries/iberia/calontiensia.txt"
LSN = "setup/countries/iberia/lusonia.txt"
TTH = "setup/countries/iberia/tithia.txt"
BLL = "setup/countries/iberia/bellia.txt"
BOL = "setup/countries/iberia/boletia.txt"
OLC = "setup/countries/iberia/olcadia.txt"
LBT = "setup/countries/iberia/lobetania.txt"
DNQ = "setup/countries/iberia/duniquia.txt"
MOC = "setup/countries/iberia/moeniccia.txt"
AEL = "setup/countries/iberia/aelariquia.txt"
TRQ = "setup/countries/iberia/tirtaliquia.txt"
DOA = "setup/countries/iberia/duitiquia.txt"
SLC = "setup/countries/iberia/solicia.txt"
SDT = "setup/countries/iberia/sedetania.txt"
DEI = "setup/countries/iberia/deitania.txt"
EBI = "setup/countries/iberia/eburania.txt"
MTS = "setup/countries/iberia/mantesania.txt"
GRM = "setup/countries/iberia/garmania.txt"
IBA = "setup/countries/iberia/ibasim.txt"

#African

CAR = "setup/countries/africa/carthage.txt"
EGY = "setup/countries/africa/egypt.txt"
MSS = "setup/countries/africa/massaesylia.txt"
MSY = "setup/countries/africa/massylia.txt"
CYR = "setup/countries/africa/cyrenaica.txt"
MSL = "setup/countries/africa/musulami.txt"
MAU = "setup/countries/africa/mauretania.txt"
KSH = "setup/countries/africa/kush.txt"
AXM = "setup/countries/africa/aksum.txt"
MYL = "setup/countries/africa/mosylon.txt"
OPO = "setup/countries/africa/opone.txt"
MND = "setup/countries/africa/mundus.txt"
AVL = "setup/countries/africa/avalites.txt"
ADO = "setup/countries/africa/adouli.txt"
YEH = "setup/countries/africa/yeha.txt"
GWN = "setup/countries/africa/gwanara.txt"
BOR = "setup/countries/africa/boras.txt"
AUT = "setup/countries/africa/alut.txt"
BMY = "setup/countries/africa/blemmyes.txt"
ACO = "setup/countries/africa/achola.txt"
HDR = "setup/countries/africa/hadrametum.txt"
LPT = "setup/countries/africa/leptis.txt"
TPS = "setup/countries/africa/thapsus.txt"
UTC = "setup/countries/africa/utica.txt"
TRP = "setup/countries/africa/tripolitania.txt"
EMP = "setup/countries/africa/emporia.txt"
IOL = "setup/countries/africa/iol.txt"
KUA = "setup/countries/africa/kerkouane.txt"
DOD = "setup/countries/africa/dodekaschoinos.txt"
DAL = "setup/countries/africa/elaia.txt"

#Gaul

ABC = "setup/countries/gaul/albici.txt"
ALL = "setup/countries/gaul/allobroges.txt"
ARC = "setup/countries/gaul/arecomici.txt"
AVN = "setup/countries/gaul/arverni.txt"
BTU = "setup/countries/gaul/bituriges.txt"
CDC = "setup/countries/gaul/cadurci.txt"
CNS = "setup/countries/gaul/consoranni.txt"
HVI = "setup/countries/gaul/helvii.txt"
NTB = "setup/countries/gaul/nitiobroges.txt"
RUT = "setup/countries/gaul/ruteni.txt"
SLV = "setup/countries/gaul/salluvi.txt"
SGL = "setup/countries/gaul/seguslavi.txt"
SRB = "setup/countries/gaul/sorbones.txt"
SRD = "setup/countries/gaul/sordones.txt"
TRB = "setup/countries/gaul/tarbelli.txt"
TRS = "setup/countries/gaul/tarusates.txt"
TCT = "setup/countries/gaul/tectosages.txt"
VOC = "setup/countries/gaul/vocontii.txt"
DCA = "setup/countries/gaul/deciates.txt"
OXB = "setup/countries/gaul/oxybii.txt"
CTR = "setup/countries/gaul/caturiges.txt"
ASC = "setup/countries/gaul/auscii.txt"
BIG = "setup/countries/gaul/bigerriones.txt"
CCS = "setup/countries/gaul/cocosates.txt"
VCT = "setup/countries/gaul/vocates.txt"
SBZ = "setup/countries/gaul/sibuzates.txt"
PTC = "setup/countries/gaul/petrocorii.txt"
LMV = "setup/countries/gaul/lemovices.txt"
SNT = "setup/countries/gaul/santones.txt"
HMK = "setup/countries/gaul/hemeroskopeion.txt"
HVT = "setup/countries/gaul/helveti.txt"
VNN = "setup/countries/gaul/vennones.txt"
TLG = "setup/countries/gaul/tulingi.txt"
ESO = "setup/countries/gaul/estiones.txt"
BRG = "setup/countries/gaul/briganti.txt"
CTN = "setup/countries/gaul/catenates.txt"
TIG = "setup/countries/gaul/tigurini.txt"
TOU = "setup/countries/gaul/tougeni.txt"
VRB = "setup/countries/gaul/verbigeni.txt"
RAU = "setup/countries/gaul/rauraci.txt"
LTG = "setup/countries/gaul/latobrigi.txt"
SVC = "setup/countries/gaul/sevaces.txt"
BGT = "setup/countries/gaul/biturigestwo.txt"
CRN = "setup/countries/gaul/carnutes.txt"
PCS = "setup/countries/gaul/pictones.txt"
TRO = "setup/countries/gaul/turones.txt"
CMI = "setup/countries/gaul/cenomanni.txt"
NMN = "setup/countries/gaul/namnetes.txt"
ADC = "setup/countries/gaul/andecamulenses.txt"
RDO = "setup/countries/gaul/redones.txt"
EBV = "setup/countries/gaul/eburovices.txt"
DBL = "setup/countries/gaul/diablintes.txt"
LXV = "setup/countries/gaul/lexovii.txt"
OSM = "setup/countries/gaul/osismi.txt"
VTN = "setup/countries/gaul/veneti.txt"
CIO = "setup/countries/gaul/curiosolites.txt"
VNL = "setup/countries/gaul/venelli.txt"
ESV = "setup/countries/gaul/esuvi.txt"
VCL = "setup/countries/gaul/veliocasses.txt"
AMB = "setup/countries/gaul/ambarri.txt"
AED = "setup/countries/gaul/aedui.txt"
SQI = "setup/countries/gaul/sequani.txt"
LNG = "setup/countries/gaul/lingones.txt"
MDB = "setup/countries/gaul/mandubii.txt"
SNN = "setup/countries/gaul/senones.txt"
TRC = "setup/countries/gaul/tricasses.txt"
PRS = "setup/countries/gaul/parisii.txt"
CTL = "setup/countries/gaul/catalauni.txt"
TBC = "setup/countries/gaul/tribocci.txt"
LCI = "setup/countries/gaul/leuci.txt"
MDM = "setup/countries/gaul/mediomatrici.txt"
NMI = "setup/countries/gaul/nemeti.txt"
TVI = "setup/countries/gaul/treveri.txt"
VNG = "setup/countries/gaul/vangiones.txt"
ADT = "setup/countries/gaul/aduatuci.txt"
EBS = "setup/countries/gaul/eburones.txt"
MNP = "setup/countries/gaul/menapi.txt"
CGN = "setup/countries/gaul/cugerni.txt"
MRN = "setup/countries/gaul/morini.txt"
NRV = "setup/countries/gaul/nervii.txt"
RMI = "setup/countries/gaul/remi.txt"
CLT = "setup/countries/gaul/caleti.txt"
BLV = "setup/countries/gaul/bellovaci.txt"
ABM = "setup/countries/gaul/ambiani.txt"
VMD = "setup/countries/gaul/viromandui.txt"
SSS = "setup/countries/gaul/suessiones.txt"
MAS = "setup/countries/gaul/massilia.txt"
BOA = "setup/countries/gaul/boioioi.txt"

#Illyria and Dacia
CAA = "setup/countries/illyria_dacia/catari.txt"
DRI = "setup/countries/illyria_dacia/daorsi.txt"
DLM = "setup/countries/illyria_dacia/delmatae.txt"
DIT = "setup/countries/illyria_dacia/iapodes.txt"
LTB = "setup/countries/illyria_dacia/latobici.txt"
LBN = "setup/countries/illyria_dacia/liberni.txt"
PII = "setup/countries/illyria_dacia/pieri.txt"
BCI = "setup/countries/illyria_dacia/breuci.txt"
ABI = "setup/countries/illyria_dacia/abrii.txt"
CVI = "setup/countries/illyria_dacia/cavii.txt"
DUI = "setup/countries/illyria_dacia/deuri.txt"
PNN = "setup/countries/illyria_dacia/pannoni.txt"
DNT = "setup/countries/illyria_dacia/ditiones.txt"
DND = "setup/countries/illyria_dacia/dindari.txt"
SCD = "setup/countries/illyria_dacia/scordici.txt"
AMI = "setup/countries/illyria_dacia/armistae.txt"
OXU = "setup/countries/illyria_dacia/oxuaioi.txt"
OTN = "setup/countries/illyria_dacia/cotini.txt"
HCN = "setup/countries/illyria_dacia/hercuniati.txt"
EVS = "setup/countries/illyria_dacia/eravisci.txt"
TLT = "setup/countries/illyria_dacia/tilataei.txt"
MOE = "setup/countries/illyria_dacia/moesi.txt"
TBL = "setup/countries/illyria_dacia/triballoi.txt"
GTE = "setup/countries/illyria_dacia/getae.txt"
POT = "setup/countries/illyria_dacia/potulatenses.txt"
SLD = "setup/countries/illyria_dacia/saldenses.txt"
ABN = "setup/countries/illyria_dacia/albocenses.txt"
BUD = "setup/countries/illyria_dacia/buridavenses.txt"
RAT = "setup/countries/illyria_dacia/ratacenses.txt"
APP = "setup/countries/illyria_dacia/appuli.txt"
CAC = "setup/countries/illyria_dacia/caucoenses.txt"
ANS = "setup/countries/illyria_dacia/ansamenses.txt"
TYR = "setup/countries/illyria_dacia/tyrgetae.txt"
NRC = "setup/countries/illyria_dacia/norici.txt"
TSC = "setup/countries/illyria_dacia/taurisci.txt"
TLN = "setup/countries/illyria_dacia/taulantii.txt"
DRD = "setup/countries/illyria_dacia/dardani.txt"
SDI = "setup/countries/illyria_dacia/serdi.txt"

#Arabia
SHB = "setup/countries/arabia/sheba.txt"
MIN = "setup/countries/arabia/ma'in.txt"
QTB = "setup/countries/arabia/qataba.txt"
HDM = "setup/countries/arabia/hadhramut.txt"
HMJ = "setup/countries/arabia/himjar.txt"
NBT = "setup/countries/arabia/nabatea.txt"
LHY = "setup/countries/arabia/lihyan.txt"
MAK = "setup/countries/arabia/maka.txt"
TYO = "setup/countries/arabia/tylos.txt"
GRH = "setup/countries/arabia/gerrha.txt"
TQF = "setup/countries/arabia/thaqif.txt"
THD = "setup/countries/arabia/thamud.txt"
QDA = "setup/countries/arabia/qadaritia.txt"

#India/Tibet
MRY = "setup/countries/india/mauryas.txt"
SHU = "setup/countries/india/shule.txt"
PHY = "setup/countries/india/phryni.txt"
WUS = "setup/countries/india/wusun.txt"
TAY = "setup/countries/india/tayuan.txt"
SOG = "setup/countries/india/sogdia.txt"
KHT = "setup/countries/india/khotan.txt"
LOL = "setup/countries/india/loulan.txt"
KSA = "setup/countries/india/kusan.txt"
PSH = "setup/countries/india/pishan.txt"
PND = "setup/countries/india/pandyas.txt"
CHR = "setup/countries/india/cheras.txt"
AYY = "setup/countries/india/ay.txt"
CHL = "setup/countries/india/cholas.txt"
STY = "setup/countries/india/satiyaputa.txt"
ANU = "setup/countries/india/anuradhapura.txt"
MSH = "setup/countries/india/mahisha.txt"
ASM = "setup/countries/india/ashmaka.txt"
ANH = "setup/countries/india/andhra.txt"
KAL = "setup/countries/india/kalinga.txt"
PIT = "setup/countries/india/pitinika.txt"
BOJ = "setup/countries/india/bhoja.txt"
KUN = "setup/countries/india/kuntala.txt"
ALU = "setup/countries/india/alupa.txt"
RTI = "setup/countries/india/rathikas.txt"
KRP = "setup/countries/india/kamarupa.txt"
IDR = "setup/countries/india/indravana.txt"
KRA = "setup/countries/india/karusa.txt"
ZHZ = "setup/countries/india/zhangzhung.txt"
YRL = "setup/countries/india/yarlung.txt"
SMP = "setup/countries/india/sumpa.txt"
TSA = "setup/countries/india/tsang.txt"
ATV = "setup/countries/india/atavia.txt"
GHA = "setup/countries/india/gandhara.txt"
PRA = "setup/countries/india/paurava.txt"
YDD = "setup/countries/india/yadheuya.txt"
NBA = "setup/countries/india/nabha.txt"
NBP = "setup/countries/india/nabapankti.txt"
SMT = "setup/countries/india/samatata.txt"
HYA = "setup/countries/india/haihaya.txt"
PLD = "setup/countries/india/palada.txt"
RHN = "setup/countries/india/ruhunu.txt"
MLY = "setup/countries/india/malaya.txt"
PRB = "setup/countries/india/parambu.txt"
KSR = "setup/countries/india/kosar.txt"
ADG = "setup/countries/india/adagaiman.txt"
KHB = "setup/countries/india/khambojas.txt"
KLS = "setup/countries/india/kalasas.txt"

#New
BKT = "setup/countries/india/beikthano.txt"
MGM = "setup/countries/india/maingmaw.txt"
BNK = "setup/countries/india/binnaka.txt"
HLN = "setup/countries/india/halin.txt"
SRK = "setup/countries/india/sri_ksetra.txt"
KNT = "setup/countries/india/kintamani.txt"
KPH = "setup/countries/india/kapah.txt"
MSG = "setup/countries/india/musang.txt"
BTG = "setup/countries/india/bintong.txt"
JHR = "setup/countries/india/johor.txt"
LGG = "setup/countries/india/long_giao.txt"
GNG = "setup/countries/india/giong_phet.txt"
ODG = "setup/countries/india/oudong.txt"
RGD = "setup/countries/india/raung_dapey.txt"
KTE = "setup/countries/india/kratie.txt"
SRG = "setup/countries/india/samrang_sen.txt"
LGS = "setup/countries/india/laang_spean.txt"
FUN = "setup/countries/india/funan.txt"

#Germanic
BST = "setup/countries/germania/bastarnae.txt"
SXS = "setup/countries/germania/saxones.txt"
CMB = "setup/countries/germania/cimbria.txt"
VDL = "setup/countries/germania/aetelrugia.txt"
TIT = "setup/countries/germania/teutonia.txt"
GIT = "setup/countries/germania/gutonia.txt"
SWE = "setup/countries/germania/suionia.txt"
RUG = "setup/countries/germania/grania.txt"
RAM = "setup/countries/germania/raumaricia.txt"
HRE = "setup/countries/germania/herules.txt"
VRI = "setup/countries/germania/varinia.txt"
LGI = "setup/countries/germania/lugia.txt"
ANG = "setup/countries/germania/anglia.txt"
AES = "setup/countries/germania/aestia.txt"
LVA = "setup/countries/germania/lemovia.txt"
SMN = "setup/countries/germania/semnonia.txt"
LGB = "setup/countries/germania/langobardia.txt"
MCM = "setup/countries/germania/marcomannia.txt"
CHC = "setup/countries/germania/chaucia.txt"

#Bactrian
PRN = "setup/countries/bactria/parni.txt"
ZNT = "setup/countries/bactria/zanthi.txt"
PSS = "setup/countries/bactria/pissuri.txt"
KRZ = "setup/countries/bactria/kharesmia.txt"
ARS = "setup/countries/bactria/arachosia.txt"

#Extra Crimea
SCY = "setup/countries/greece/scythia_europea.txt"
ZGY = "setup/countries/caucasiamesopotamia/zygia.txt"
HNY = "setup/countries/caucasiamesopotamia/heniochia.txt"
PHI = "setup/countries/caucasiamesopotamia/phasis.txt"

#Extra Germany
BUR = "setup/countries/germania/burgundia.txt"
DAN = "setup/countries/germania/dania.txt"
LEU = "setup/countries/germania/leuonia.txt"
GTH = "setup/countries/germania/gothonia.txt"
RGG = "setup/countries/germania/rugiagermania.txt"
SCI = "setup/countries/germania/sciria.txt"
FOS = "setup/countries/germania/fosia.txt"
REU = "setup/countries/germania/reudignia.txt"
AVO = "setup/countries/germania/aviones.txt"
CRS = "setup/countries/germania/cherusci.txt"
EUD = "setup/countries/germania/eudosi.txt"
AGR = "setup/countries/germania/angrivaria.txt"

#Nuragic
IOI = "setup/countries/nuragic/iolensia.txt"
BLR = "setup/countries/nuragic/balaria.txt"

#Extra Ireland
DAR = "setup/countries/britannia/darinia.txt"
ELA = "setup/countries/britannia/eblania.txt"
MNA = "setup/countries/britannia/manapia.txt"
CAU = "setup/countries/britannia/caucia.txt"
COR = "setup/countries/britannia/coriondia.txt"
IVE = "setup/countries/britannia/ivernia.txt"
USD = "setup/countries/britannia/usdia.txt"
ROB = "setup/countries/britannia/robogdia.txt"
VEN = "setup/countries/britannia/venicnia.txt"
BGA = "setup/countries/britannia/brigantia.txt"

#Extra Scotland
CAN = "setup/countries/britannia/carnonacia.txt"
CON = "setup/countries/britannia/cornavia.txt"

# Extra Baltic
VND = "setup/countries/germania/venedia.txt"
SUD = "setup/countries/germania/sudinoia.txt"
SLO = "setup/countries/germania/saloia.txt"

#Extra Italy
ELE = "setup/countries/italia/elea.txt"

# Extra Sicily
GEL = "setup/countries/italia/gelas.txt"
HEM = "setup/countries/italia/herakleia_minoa.txt"
TYN = "setup/countries/italia/tyndaria.txt"
CLA = "setup/countries/italia/calactea.txt"
SIN = "setup/countries/italia/selinous.txt"

# Extra Boeotia
AMP = "setup/countries/greece/amphissa.txt"
OPU = "setup/countries/greece/opus.txt"
PHO = "setup/countries/greece/phocis.txt"
DLP = "setup/countries/greece/delphi.txt"

# Epirus
AMK = "setup/countries/greece/ambrakia.txt"

# Crete
LAP = "setup/countries/greece/lappa.txt"
ARD = "setup/countries/greece/arcades.txt"

# Maedia
MAD = "setup/countries/greece/maedia.txt"

# Illyrian islands
ASP = "setup/countries/illyria_dacia/asparos.txt"
PHA = "setup/countries/illyria_dacia/pharos.txt"
EPM = "setup/countries/illyria_dacia/epidaurum.txt"
ISA = "setup/countries/illyria_dacia/issa.txt"
KOK = "setup/countries/illyria_dacia/korkyramelaina.txt"
APO = "setup/countries/illyria_dacia/apollonia.txt"

### Marius Anatolia
SLG = "setup/countries/anatolia/selgia.txt"
TRM = "setup/countries/anatolia/termessia.txt"
SSG = "setup/countries/anatolia/sagalassia.txt"
KTN = "setup/countries/anatolia/kotennia.txt"
PDL = "setup/countries/anatolia/pednelissia.txt"
HMD = "setup/countries/anatolia/homanadia.txt"
SMS = "setup/countries/anatolia/sesamos.txt"
TIE = "setup/countries/anatolia/tieion.txt"
LYC = "setup/countries/anatolia/lycia.txt"
ISU = "setup/countries/anatolia/isauria.txt"
LAR = "setup/countries/anatolia/larandia.txt"
MYD = "setup/countries/anatolia/mariandynia.txt"
AKY = "setup/countries/anatolia/arykandia.txt"
ORO = "setup/countries/anatolia/oroandia.txt"
ABL = "setup/countries/anatolia/ambladia.txt"
ISI = "setup/countries/anatolia/isindia.txt"
LAL = "setup/countries/anatolia/lalasia.txt"
KEN = "setup/countries/anatolia/kennataia.txt"
OEO = "setup/countries/anatolia/oenoandia.txt"
KIB = "setup/countries/anatolia/kibyratia.txt"
OML = "setup/countries/anatolia/ormelia.txt"
TYM = "setup/countries/anatolia/tymandia.txt"
KAK = "setup/countries/anatolia/kaukonia.txt"
OBE = "setup/countries/anatolia/olbe.txt"

### New Countries

# Britannia
NEM = "setup/countries/britannia/nemetia.txt"
NOV = "setup/countries/britannia/noviomagus.txt"
CUN = "setup/countries/britannia/cunetio.txt"
VER = "setup/countries/britannia/verulamium.txt"
DUO = "setup/countries/britannia/durobrivae.txt"
SEG = "setup/countries/britannia/seguntium.txt"
GOB = "setup/countries/britannia/gobannium.txt"
VRT = "setup/countries/britannia/vertis.txt"
CSE = "setup/countries/britannia/causennae.txt"
HES = "setup/countries/britannia/hessulum.txt"
MAM = "setup/countries/britannia/mamicum.txt"
SET = "setup/countries/britannia/setantorium.txt"
HAB = "setup/countries/britannia/habitancum.txt"
SGV = "setup/countries/britannia/selgovae.txt"

# Mesopotamia
MEE = "setup/countries/mesopotamia/media.txt"
PER = "setup/countries/mesopotamia/persia.txt"
GED = "setup/countries/mesopotamia/gedrosia.txt"
UTI = "setup/countries/mesopotamia/utia.txt"
HYR = "setup/countries/mesopotamia/hyrcania.txt"
AMZ = "setup/countries/mesopotamia/amaseia.txt"
PTR = "setup/countries/mesopotamia/pteria.txt"
MRK = "setup/countries/mesopotamia/markash.txt"
DLC = "setup/countries/mesopotamia/doliche.txt"
TZR = "setup/countries/mesopotamia/tzur.txt"
RRN = "setup/countries/mesopotamia/arran.txt"
KSS = "setup/countries/mesopotamia/kurus.txt"
BRJ = "setup/countries/mesopotamia/borjomi.txt"
HKH = "setup/countries/mesopotamia/hokhmik.txt"
CMY = "setup/countries/mesopotamia/cambysene.txt"
AHN = "setup/countries/mesopotamia/artahan.txt"
ELM = "setup/countries/mesopotamia/elam.txt"
CHD = "setup/countries/mesopotamia/chaldean.txt"
LYD = "setup/countries/mesopotamia/lydia.txt"
CIL = "setup/countries/mesopotamia/cilicia.txt"

# Italia
MSN = "setup/countries/italia/messana.txt"
THM = "setup/countries/italia/thermai.txt"
HPP = "setup/countries/italia/hippana.txt"
KAT = "setup/countries/italia/katane.txt"
STC = "setup/countries/italia/stylacium.txt"
CTP = "setup/countries/italia/centuripae.txt"
PTL = "setup/countries/italia/petelia.txt"
BNT = "setup/countries/italia/brentesion.txt"
CPA = "setup/countries/italia/capua.txt"
STL = "setup/countries/italia/saticula.txt"
PTN = "setup/countries/italia/peltuinum.txt"
ACE = "setup/countries/italia/aeclanum.txt"
PST = "setup/countries/italia/paestum.txt"
BAT = "setup/countries/italia/bantia.txt"
LKR = "setup/countries/italia/kanysion.txt"
FCL = "setup/countries/italia/ficline.txt"
VLC = "setup/countries/italia/velcal.txt"
TCH = "setup/countries/italia/tarchuna.txt"
CLS = "setup/countries/italia/cleusi.txt"
ICM = "setup/countries/italia/icuvium.txt"
OLI = "setup/countries/italia/olbia.txt"
ALO = "setup/countries/italia/alouka.txt"
LIA = "setup/countries/italia/alalia.txt"

# Greece
IOU = "setup/countries/greece/ioulis.txt"
SIK = "setup/countries/greece/sikyon.txt"
AGN = "setup/countries/greece/aigina.txt"
CLK = "setup/countries/greece/chalkis.txt"
SKY = "setup/countries/greece/skyros.txt"
LAM = "setup/countries/greece/lamia.txt"
HYP = "setup/countries/greece/hypata.txt"
PHR = "setup/countries/greece/pharsalos.txt"
THS = "setup/countries/greece/thessaly.txt"
PYD = "setup/countries/greece/pydna.txt"
DIO = "setup/countries/greece/dion.txt"
APS = "setup/countries/greece/amphipolis.txt"
CKD = "setup/countries/greece/chalkidiki.txt"
BYL = "setup/countries/greece/byllis.txt"
LYN = "setup/countries/greece/lychnidos.txt"
PLG = "setup/countries/greece/pelagonia.txt"
LSS = "setup/countries/greece/lissos.txt"
ZEL = "setup/countries/greece/zeleia.txt"
ASS = "setup/countries/greece/assos.txt"
ADY = "setup/countries/greece/adramyttion.txt"
EAA = "setup/countries/greece/elaia.txt"
MYT = "setup/countries/greece/mytilene.txt"
KYM = "setup/countries/greece/kyme.txt"
IMB = "setup/countries/greece/imbros.txt"
HST = "setup/countries/greece/hephaistaia.txt"
CHO = "setup/countries/greece/chios.txt"
BIS = "setup/countries/greece/bisanthe.txt"
ABD = "setup/countries/greece/abdera.txt"
ANN = "setup/countries/greece/ainos.txt"
TSS = "setup/countries/greece/tarsus.txt"
KYR = "setup/countries/greece/kyrenia.txt"
SKP = "setup/countries/greece/salamis_kyprias.txt"
KIT = "setup/countries/greece/kition.txt"
MRO = "setup/countries/greece/marion.txt"
PPS = "setup/countries/greece/paphos.txt"
KNS = "setup/countries/greece/kaunos.txt"
ALD = "setup/countries/greece/alabanda.txt"
MYA = "setup/countries/greece/mylasa.txt"
PEE = "setup/countries/greece/priene.txt"
EHS = "setup/countries/greece/ephesos.txt"
SMO = "setup/countries/greece/samos.txt"
KLM = "setup/countries/greece/kalymnos.txt"
PSD = "setup/countries/greece/poseidon.txt"
AYP = "setup/countries/greece/astypalaia.txt"
THA = "setup/countries/greece/thera.txt"
NXS = "setup/countries/greece/naxos.txt"
PRX = "setup/countries/greece/paros.txt"
MLS = "setup/countries/greece/melos.txt"
PSR = "setup/countries/greece/passaron.txt"
LYS = "setup/countries/greece/lysimacheia.txt"
LND = "setup/countries/greece/lindos.txt"
ILY = "setup/countries/greece/ialysus.txt"
KMS = "setup/countries/greece/kameiros.txt"
THR = "setup/countries/greece/therma.txt"

# Africa
ZIT = "setup/countries/africa/zitha.txt"
OYA = "setup/countries/africa/oyat.txt"
DRR = "setup/countries/africa/durai.txt"
DMR = "setup/countries/africa/demora.txt"
ALT = "setup/countries/africa/fur.txt"
SST = "setup/countries/africa/sabaste.txt"
ASW = "setup/countries/africa/aswan.txt"
MAX = "setup/countries/africa/maxyesia.txt"
ZEU = "setup/countries/africa/zeugitana.txt"
TBR = "setup/countries/africa/thrabracania.txt"
CLM = "setup/countries/africa/calama.txt"
AUA = "setup/countries/africa/aurasius.txt"
SLE = "setup/countries/africa/saldae.txt"
RSC = "setup/countries/africa/rusuccuru.txt"
MTG = "setup/countries/africa/metagonian.txt"
CRT = "setup/countries/africa/cartili.txt"
CDR = "setup/countries/africa/caudium_castra.txt"
TGT = "setup/countries/africa/tingitania.txt"
RTB = "setup/countries/africa/rutubis.txt"
KHD = "setup/countries/africa/khedis.txt"
BYS = "setup/countries/africa/byssatis.txt"
QRN = "setup/countries/africa/qartan.txt"
RSD = "setup/countries/africa/rusaddir.txt"
MLX = "setup/countries/africa/malaka.txt"
DBT = "setup/countries/africa/abderat.txt"
QRT = "setup/countries/africa/qarta.txt"
TNG = "setup/countries/africa/tinga.txt"
SHL = "setup/countries/africa/shalat.txt"

# Arabia
AKA = "setup/countries/arabia/aka.txt"
APN = "setup/countries/arabia/apollonia.txt"
GLL = "setup/countries/arabia/galilee.txt"
FIL = "setup/countries/arabia/philistia.txt"
PEA = "setup/countries/arabia/peraea.txt"
DED = "setup/countries/arabia/dedan.txt"
EGR = "setup/countries/arabia/egra.txt"
CMT = "setup/countries/arabia/charamithas.txt"
HAR = "setup/countries/arabia/harbia.txt"
LTA = "setup/countries/arabia/litha.txt"
MRM = "setup/countries/arabia/marma.txt"
QAN = "setup/countries/arabia/qana.txt"
QIS = "setup/countries/arabia/quishan.txt"

# Iberia
BND = "setup/countries/iberia/blandae.txt"
SGR = "setup/countries/iberia/sigarra.txt"
ETB = "setup/countries/iberia/etobesa.txt"
SLU = "setup/countries/iberia/salduie.txt"
ELC = "setup/countries/iberia/elioucroca.txt"
URK = "setup/countries/iberia/urki.txt"
SLT = "setup/countries/iberia/saltigi.txt"
VLR = "setup/countries/iberia/valeria.txt"
LOT = "setup/countries/iberia/loutia.txt"
LNI = "setup/countries/iberia/langni.txt"
CEL = "setup/countries/iberia/celsa.txt"
OSC = "setup/countries/iberia/osca.txt"
VAR = "setup/countries/iberia/vareia.txt"
FLV = "setup/countries/iberia/flaviobriga.txt"
LCB = "setup/countries/iberia/lacobriga.txt"
RDA = "setup/countries/iberia/rauda.txt"
SMC = "setup/countries/iberia/septimanca.txt"
NVR = "setup/countries/iberia/nivaria.txt"
LMA = "setup/countries/iberia/lama.txt"
LRG = "setup/countries/iberia/langobriga.txt"
CSP = "setup/countries/iberia/caspiana.txt"
NRB = "setup/countries/iberia/norba.txt"
TPR = "setup/countries/iberia/taporia.txt"
OLS = "setup/countries/iberia/olisipo.txt"
SLA = "setup/countries/iberia/solia.txt"
BCL = "setup/countries/iberia/baecula.txt"
EPR = "setup/countries/iberia/epora.txt"
IGB = "setup/countries/iberia/igabrum.txt"
SGD = "setup/countries/iberia/segida.txt"
CTM = "setup/countries/iberia/cartima.txt"
IRN = "setup/countries/iberia/irni.txt"
HSP = "setup/countries/iberia/hispalis.txt"
NEV = "setup/countries/iberia/naeva.txt"
FDN = "setup/countries/iberia/fodinae.txt"
CNE = "setup/countries/iberia/couneia.txt"
MYR = "setup/countries/iberia/myrtilis.txt"
MCR = "setup/countries/iberia/microbigensia.txt"

# Gaul
GNA = "setup/countries/gaul/genua.txt"
RGM = "setup/countries/gaul/rigomagus.txt"
LML = "setup/countries/gaul/laumellum.txt"
PLC = "setup/countries/gaul/placentia.txt"
LMB = "setup/countries/gaul/lambrum.txt"
BRX = "setup/countries/gaul/brixia.txt"
HTR = "setup/countries/gaul/hatria.txt"
AUR = "setup/countries/gaul/auraei.txt"
AQL = "setup/countries/gaul/aquileia.txt"
SGA = "setup/countries/gaul/segosa.txt"
TVC = "setup/countries/gaul/travectus.txt"
BRS = "setup/countries/gaul/burgus.txt"
USR = "setup/countries/gaul/userca.txt"
GRG = "setup/countries/gaul/gergovia.txt"
VLG = "setup/countries/gaul/vologatae.txt"
BTN = "setup/countries/gaul/boutae.txt"
BBC = "setup/countries/gaul/bibracte.txt"
DCT = "setup/countries/gaul/decetia.txt"
CBA = "setup/countries/gaul/cubia.txt"
ONA = "setup/countries/gaul/onia.txt"
BLS = "setup/countries/gaul/blesum.txt"
BLC = "setup/countries/gaul/belca.txt"
BGS = "setup/countries/gaul/brigiosa.txt"
BCC = "setup/countries/gaul/bricca.txt"
VTV = "setup/countries/gaul/vertavia.txt"
BCM = "setup/countries/gaul/becciacumi.txt"

# Illyria
TRT = "setup/countries/illyria/tarsatica.txt"
OTP = "setup/countries/illyria/ortopla.txt"
TRG = "setup/countries/illyria/tragourion.txt"
BLA = "setup/countries/illyria/baloia.txt"
VLD = "setup/countries/illyria/valdasus.txt"
MSO = "setup/countries/illyria/marsonia.txt"
MSA = "setup/countries/illyria/moesiana.txt"
ARB = "setup/countries/illyria/arraboa.txt"
SAA = "setup/countries/illyria/salia.txt"
DRV = "setup/countries/illyria/dravia.txt"

# Scythia
CRX = "setup/countries/scythia/charax.txt"
LPS = "setup/countries/scythia/lampas.txt"
ATN = "setup/countries/scythia/athenaion.txt"
TCA = "setup/countries/scythia/taurica.txt"
TFS = "setup/countries/scythia/taphros.txt"
GGP = "setup/countries/scythia/gorgippia.txt"
SLY = "setup/countries/scythia/salavy.txt"
AZR = "setup/countries/scythia/azara.txt"
CLP = "setup/countries/scythia/clepia.txt"
HLM = "setup/countries/scythia/halmyris.txt"
RDP = "setup/countries/scythia/rhodope.txt"
BGL = "setup/countries/scythia/bergoule.txt"
HMN = "setup/countries/scythia/haemimontus.txt"
TYL = "setup/countries/scythia/tylis.txt"
HLS = "setup/countries/scythia/helis.txt"
BNS = "setup/countries/scythia/ballanstra.txt"
RTR = "setup/countries/scythia/ratiara.txt"
TSM = "setup/countries/scythia/tiasum.txt"
SRN = "setup/countries/scythia/sornus.txt"
RXL = "setup/countries/scythia/roxolania.txt"
HRG = "setup/countries/scythia/hargita.txt"
DRN = "setup/countries/scythia/diernan.txt"
PTE = "setup/countries/scythia/putea.txt"

# Asia
TEK = "setup/countries/asia/teike.txt"
SHK = "setup/countries/asia/shakthara.txt"
KMD = "setup/countries/asia/kumdah.txt"
CMR = "setup/countries/asia/chomaria.txt"
FRG = "setup/countries/asia/ferghana.txt"
CAH = "setup/countries/asia/chach.txt"
AML = "setup/countries/asia/amul.txt"
MRG = "setup/countries/asia/margiana.txt"
TPU = "setup/countries/asia/tapuria.txt"
GDA = "setup/countries/asia/godana.txt"
ARX = "setup/countries/asia/aria.txt"
AXX = "setup/countries/asia/artousa.txt"
STT = "setup/countries/asia/sattagydia.txt"
PRP = "setup/countries/asia/parapamsidae.txt"
ABT = "setup/countries/asia/arbiti.txt"
CTB = "setup/countries/asia/contabura.txt"
BSK = "setup/countries/asia/baskata.txt"
ATA = "setup/countries/asia/atara.txt"
PMR = "setup/countries/asia/pamir.txt"
LSH = "setup/countries/asia/lashang.txt"
BRM = "setup/countries/asia/barma.txt"
SMY = "setup/countries/asia/samye.txt"
KBT = "setup/countries/asia/rabten.txt"
SUM = "setup/countries/asia/sumpa.txt"
KRM = "setup/countries/asia/karmana.txt"
APD = "setup/countries/asia/aspadana.txt"
CTA = "setup/countries/asia/cataonia.txt"
IRS = "setup/countries/asia/iris.txt"
SRC = "setup/countries/asia/syracene.txt"
AYR = "setup/countries/asia/ayrarat.txt"
ADB = "setup/countries/asia/adiabene.txt"
GRE = "setup/countries/asia/garamaea.txt"
KYL = "setup/countries/asia/kyropolis.txt"
PRC = "setup/countries/asia/parachatros.txt"
CRD = "setup/countries/asia/corduene.txt"
SPH = "setup/countries/asia/sophene.txt"
TLR = "setup/countries/asia/talaura.txt"
ANI = "setup/countries/asia/ani.txt"
ATS = "setup/countries/asia/artshak.txt"
TRW = "setup/countries/asia/tarawan.txt"
VSP = "setup/countries/asia/vaspurakan.txt"
BLY = "setup/countries/asia/bulya.txt"
SGT = "setup/countries/asia/sagarita.txt"
TRX = "setup/countries/asia/traxiane.txt"
KAN = "setup/countries/asia/karana.txt"
SNR = "setup/countries/asia/sinoria.txt"
TBI = "setup/countries/asia/tabiene.txt"
ACX = "setup/countries/asia/arctiene.txt"
CMN = "setup/countries/asia/comisene.txt"
IST = "setup/countries/asia/issatis.txt"

# India
DHI = "setup/countries/india/dhingyawati.txt"
PGJ = "setup/countries/india/pragjyotisa.txt"
KRT = "setup/countries/india/kirata.txt"
AGA = "setup/countries/india/anga.txt"
MGD = "setup/countries/india/magadha.txt"
MLA = "setup/countries/india/malla.txt"
KSL = "setup/countries/india/kosala.txt"
VTS = "setup/countries/india/vatsa.txt"
KSI = "setup/countries/india/kasi.txt"
AVT = "setup/countries/india/avanti.txt"
SUA = "setup/countries/india/surasena.txt"
MTY = "setup/countries/india/matsya.txt"
SHT = "setup/countries/india/surashtra.txt"
NSD = "setup/countries/india/nishada.txt"
PCT = "setup/countries/india/pactyans.txt"
KRU = "setup/countries/india/kuru.txt"
NBH = "setup/countries/india/nabhakas.txt"
PDR = "setup/countries/india/pundra.txt"
RJG = "setup/countries/india/rajagagrha.txt"
NLD = "setup/countries/india/nalanda.txt"
KSV = "setup/countries/india/kusavati.txt"
PPP = "setup/countries/india/pipphalivana.txt"
ACT = "setup/countries/india/ahicchatra.txt"
UNO = "setup/countries/india/unnao.txt"
KHP = "setup/countries/india/kahnpuria.txt"
BTS = "setup/countries/india/batesar.txt"
CDI = "setup/countries/india/cedi.txt"
DSR = "setup/countries/india/dasarna.txt"
DAU = "setup/countries/india/dausa.txt"
MDY = "setup/countries/india/madhyamika.txt"
MRU = "setup/countries/india/maru.txt"
ABR = "setup/countries/india/abhira.txt"
PLN = "setup/countries/india/patalene.txt"
DRA = "setup/countries/india/daria.txt"
SVR = "setup/countries/india/sauvira.txt"
SDH = "setup/countries/india/sindimana.txt"
PRD = "setup/countries/india/pardene.txt"
RRK = "setup/countries/india/roruka.txt"
APR = "setup/countries/india/aparanta.txt"
VDY = "setup/countries/india/vindya.txt"
VNV = "setup/countries/india/vanavasi.txt"
HYD = "setup/countries/india/hydrakai.txt"
PCH = "setup/countries/india/panchanada.txt"
BKP = "setup/countries/india/boukephalia.txt"
KRG = "setup/countries/india/karige.txt"
MVL = "setup/countries/india/mavilankai.txt"
MTT = "setup/countries/india/mayurasattapattinam.txt"
MLG = "setup/countries/india/melange.txt"
KTT = "setup/countries/india/kottis.txt"
PTO = "setup/countries/india/pitoura.txt"
TRL = "setup/countries/india/tirumala.txt"
CGM = "setup/countries/india/changam.txt"
BDK = "setup/countries/india/bendakaluru.txt"
CTD = "setup/countries/india/chitradurga.txt"
MDN = "setup/countries/india/madana.txt"
PTH = "setup/countries/india/pattithana.txt"
DRU = "setup/countries/india/darur.txt"
IND = "setup/countries/india/indur.txt"
POA = "setup/countries/india/potana.txt"
KLY = "setup/countries/india/kalyani.txt"
KCC = "setup/countries/india/kaccha.txt"
